##############################
# .............#.............#
#..###..####...#...####..###.#
#............................#
#..###..#...########..#..###.#
#.......#......#......#......#
######..####...#...####..#####
     #..#.............#..#
............###.###...........
     #...#..#.....#...#..#
######...#..###.###...#..#####
#............................#
#..###...#.....#......#..###.#
#.....#.....#......#.........#
##....#..###..####....#...####
##############################



