##############################
#              #             #
#  ###  ####   #   ####  ### #
#                            #
#  ###  #   ########  #  ### #
#       #      #      #      #
######  ####   #   ####  #####
     #  #             #  #
            ### ###
     #   #  #     #   #  #
######   #  ### ###   #  #####
#                            #
#  ###   #     #      #  ### #
#        #     #      #      #
##    #  ###  ####    #   ####
##############################



