####################
#..##...##...####..#
#.##..######..#....#
#..##.......###....#
#...#.##.##.#......#
#.##..#.@.#.#..##..#
####..#####..#...###
.....#......###.....
###...####....#....#
####################
