####################
#.##.......###..#..#
#....##.#.##.#.#...#
#####...#.@#...#####
......#.####.#......
####..#......#..####
#..##..............#
##..#..#.....###..##
#.....######..#....#
####################

